"a" = (/turf/space,/area)
"b" = (/turf/wall,/area)
"c" = (/turf/floor,/area)
"d" = (/turf/start,/area)
"e" = (/turf/window,/area)
"f" = (/turf/airlock,/area)
"g" = (/turf/shuttle_wall,/area)
"h" = (/turf/shuttle_floor,/area)

(1,1,1) = {"
aaaaaaaaaaaaaaaaaaaaaaaaaaaaaa
aaaaaaaaaaaaaaaaaaaaaaaaaaaaaa
aaaaaaaaaaaaaaaaaaaaaaaaaaaaaa
aaaaabbbbbbbbbbbbbbbbbbbbbaaaa
aaaaabcccccccccccccccccccbaaaa
aaaaabcccccccccccccccccccbaaaa
aaaaabcccccccccccccccccccbaaaa
aaaaabcccccccccccccccccccbaaaa
aaaaabcbfbebfbcccccccccccbaaaa
aaaaaabbcbabcbbccccccccccbaaaa
aaaaaaggfgegfggccccccccccbaaaa
aaaaaaehhhhhhheccccccccccbaaaa
aaaaaaehdhhhhheccccccccccbaaaa
aaaaaaehhhhhhheccccccccccbaaaa
aaaaaaggfgegfggccccccccccbaaaa
aaaaaabbcbabcbbccccccccccbaaaa
aaaaabcbfbebfbcccccccccccbaaaa
aaaaabcccccccccccccccccccbaaaa
aaaaabcccccccccccccccccccbaaaa
aaaaabcccccccccccccccccccbaaaa
aaaaabcccccccccccccccccccbaaaa
aaaaabcccccccccccccccccccbaaaa
aaaaabbbbbbbbbbbbbbbbbbbbbaaaa
aaaaaaaaaaaaaaaaaaaaaaaaaaaaaa
aaaaaaaaaaaaaaaaaaaaaaaaaaaaaa
aaaaaaaaaaaaaaaaaaaaaaaaaaaaaa
aaaaaaaaaaaaaaaaaaaaaaaaaaaaaa
aaaaaaaaaaaaaaaaaaaaaaaaaaaaaa
aaaaaaaaaaaaaaaaaaaaaaaaaaaaaa
aaaaaaaaaaaaaaaaaaaaaaaaaaaaaa
"}
